
F 220,12,0
C 225,30,0

NO ./mnt/c/Users/AIMANE~1/desktop/school/cube/textures/149.xpm
SO ./mnt/c/Users/AIMANE~1/desktop/school/cube/textures/152.xpm
WE ./mnt/c/Users/AIMANE~1/desktop/school/cube/textures/153.xpm
EA ./mnt/c/Users/AIMANE~1/desktop/school/cube/textures/176.xpm


111111
1000N01
100001
111111