11111111111111
11000000000111
11000000000111
11000000000111
11100000000011
111000000N0011
11111111111111