11111111111111111
1N000000000000011
10000000000000011
10100001001001001
10000100000000001
10000000000000001
11111111111111111