111111111111111111111
1N0000000000100000011
100000000000000000011
101000010010010101001
101000000000000001001
101000010010010101001
100001000000000000001
100000000000000000001
111111111111111111111