1111111
1N00011
1000011
1000101
1000101
1000101
1111111