NO ./home/aimane-jadid/Desktop/studies/latesttttttt/textures/149.xpm
SO ./home/aimane-jadid/Desktop/studies/latesttttttt/textures/152.xpm
WE ./home/aimane-jadid/Desktop/studies/latesttttttt/textures/153.xpm
EA ./home/aimane-jadid/Desktop/studies/latesttttttt/textures/176.xpm
F 220,100,0
C 225,30,0

1111111111111111111111111
10E0000000000000000000001
1011000001110000000000001
1111111111111111111111111