11111111111
1N000000011
10000000011
10100001001
10000100001
10000000001
11111111111