NO ./mnt/c/Users/AIMANE~1/desktop/school/cube/textures/149.xpm
SO ./mnt/c/Users/AIMANE~1/desktop/school/cube/textures/152.xpm
WE ./mnt/c/Users/AIMANE~1/desktop/school/cube/textures/153.xpm
EA ./mnt/c/Users/AIMANE~1/desktop/school/cube/textures/176.xpm
F 220,200,200
C 225,200,200

1111111111111111111111111
10E0000000000000000000001
1011000001110000000000001
1000000000000000000000001
1111111111111111111111111