11111111111111
1N00000000111
1000000000111
1000000000111
1100000000011
11100000000011
11111111111111