NO ./home/aimane-jadid/Desktop/studies/CUBEOFF-main/textures/152.xpm
SO ./home/aimane-jadid/Desktop/studies/CUBEOFF-main/textures/149.xpm
WE ./home/aimane-jadid/Desktop/studies/CUBEOFF-main/textures/153.xpm
EA ./home/aimane-jadid/Desktop/studies/CUBEOFF-main/textures/176.xpm
F 20,20,20
C 0,0,20

 11111111111111111111111111111
1000000000000000000000000001
10111111111111111111111110001
100000000000000000000000100001
1011111111111111111111101000001
10000000000000001000001010000001
101111111111110E100000101000001
1000000000000101000001010000001
101111111111110100000101000011
1000000000000100000010100011
101111111111110000010101111
10000000000001000010111
10111111111111000011
1000000000000100011
10111111111111001
1000000000000111
1011111111111
10000000001
1011111111
1000001
101111
101
11