NO ./home/aimane-jadid/Desktop/studies/zipper/CUBEOFF-main/textures/149.xpm
SO ./home/aimane-jadid/Desktop/studies/zipper/CUBEOFF-main/textures/152.xpm
WE ./home/aimane-jadid/Desktop/studies/zipper/CUBEOFF-main/textures/153.xpm
EA ./home/aimane-jadid/Desktop/studies/zipper/CUBEOFF-main/textures/176.xpm
F 0,0,0
C 0,0,20

111111111111111111111111111111
10E0000000000000000000000000001
1011000000010000000000000000001
100000000000000000000000011111
1111111111111111111111111